#name Complexe_map

#map
1111111111
1000000001
100N000001
100000000111111111111111111111111111111
100001000000000000000000000000000000001
100000000000000000000000000000000000001
100000000000000000000000000000000000001
100000000111111111111000111111111111111
1000000001          10001
1111111111          100011111111111111111111111111111111111111111111111
                    100000000000000000000000000000000000000000000000001
                    100000000000000000000000000000000000000000000000001
                    111111111111111111111111111110000111111111111111111
                                                100001
                                                100001
                                                100001
                                                100001
                                                100001
                                                111111