#name Complexe_map

#map
1111111111
1000000001
1000000001
100000000111111111111111111111111111111
100001000000000000000000000000000000001
100000000000000000000000000000000000001
100000000000000000000000000000000000001
100000000111111111111000111111111111111
1000000001          10001           111
1111111111          100011111111111110111111111111111111111111111111111
                    100000000000000000000000000000000000000000000000001
                    10000000000000000000E000000000000000000000010000001
                    111111111111000111110111111110000111111110011001111
                               11111   111      100001      10000001
                                                100001      11111111
                                                100001
                                                100001
                                                100001
                                                111111